888888888888888888888888888888888888888888888888888888888888
800000000000000000000000000000000000000000000000000000000008
800000000000000000000000000000000000000000000000000000000008
800800000000000000800000000000000800000000000000000000000008
800080000000000000080000000000000080000000000000000000000008
800008000000000000008000000000000008000000000000000000000008
800000800000000000000800000000000000800000000000000000000008
800000080000000000000080000000000000080000000000000000000008
800000008000000000000008000000000000008000000000000000000008
800000000800000000000000800000000000000800000000000000000008
800000000080000000000000080000000000000080000000000000000008
800000000008000000000000008000000000000008000000000000000008
800000000000800000000000000800000000000000800000000000000008
800000000000080000000000000080000000000000080000000000000008
800000000000008000000000000008000000000000008000000000000008
800000000000000800000000000000800000000000000800000000000008
800000000000000080000000000000080000000000000080000000000008
800000000000000008000000000000008000000000000008000000000008
800000000000000000800000000000000800000000000000800000000008
800000000000000000080000000000000080000000000000080000000008
800000000000000000008000000000000008000000000000008000000008
800000000000000000000800000000000000800000000000000800000008
800000000000000000000080000000000000080000000000000080000008
800000000000000000000008000000000000008000000000000008000008
800000000000000000000000800000000000000800000000000000800008
800000000000000000000000080000000000000080000000000000080008
800000000000000000000000008000000000000008000000000000008008
800000000000000000000000000000000000000000000000000000000008
800000000000000000000000000000000000000000000000000000000008
888888888888888888888888888888888888888888888888888888888888