000000000000000000000000000000000000000000000000000000000000
000000000000000000000000000000000000000000000000000000000000
000000000000000000000000000000000000000000000000000000000000
000000000000000000000000000000000000000000000000000000000000
000000000000444444444444444444444444444444444444000000000000
000000000000000000000000000000000000000000000000000000000000
000000000040000000000000000000000000000000000000040000000000
000000000040000000000000000000000000000000000000040000000000
000000000040000000000000000000000000000000000000040000000000
000000000040000000000000000000000000000000000000040000000000
000000000040000000000000000000000000000000000000040000000000
000000000040000000000000000000000000000000000000040000000000
000000000040000000000000000000000000000000000000040000000000
000000000040000000000000000000000000000000000000040000000000
000000000040000000000000000000000000000000000000040000000000
000000000040000000000000000000000000000000000000040000000000
000000000040000000000000000000000000000000000000040000000000
000000000040000000000000000000000000000000000000040000000000
000000000040000000000000000000000000000000000000040000000000
000000000040000000000000000000000000000000000000040000000000
000000000040000000000000000000000000000000000000040000000000
000000000040000000000000000000000000000000000000040000000000
000000000040000000000000000000000000000000000000040000000000
000000000040000000000000000000000000000000000000040000000000
000000000000000000000000000000000000000000000000000000000000
000000000000444444444444444444444444444444444444000000000000
000000000000000000000000000000000000000000000000000000000000
000000000000000000000000000000000000000000000000000000000000
000000000000000000000000000000000000000000000000000000000000
000000000000000000000000000000000000000000000000000000000000