666666666666666666666666666666666666666666666666666666666666
600000000000000000000000000000000000000000000000000000000006
600000000000000000000000000006000000000000000000000000000006
600000000000000000000000000000000000000000000000000000000006
600000000000000000000000000006000000000000000000000000000006
600000000000000000000000000000000000000000000000000000000006
600000000000000000000000000006000000000000000000000000000006
600000000000000000000000000000000000000000000000000000000006
600000000000000000000000000006000000000000000000000000000006
600000000000000000000000000000000000000000000000000000000006
600000000000000000000000000006000000000000000000000000000006
600000000000000000000000000000000000000000000000000000000006
600000000000000000000000000006000000000000000000000000000006
600000000000000000000000000000000000000000000000000000000006
600000000000000000000000000006000000000000000000000000000006
600000000000000000000000000000000000000000000000000000000006
600000000000000000000000000006000000000000000000000000000006
600000000000000000000000000000000000000000000000000000000006
600000000000000000000000000006000000000000000000000000000006
600000000000000000000000000000000000000000000000000000000006
600000000000000000000000000006000000000000000000000000000006
600000000000000000000000000000000000000000000000000000000006
600000000000000000000000000006000000000000000000000000000006
600000000000000000000000000000000000000000000000000000000006
600000000000000000000000000006000000000000000000000000000006
600000000000000000000000000000000000000000000000000000000006
600000000000000000000000000006000000000000000000000000000006
600000000000000000000000000000000000000000000000000000000006
600000000000000000000000000006000000000000000000000000000006
666666666666666666666666666666666666666666666666666666666666