777777777777777777777777777777777777777777777777777777777777
700000000700000000000000000007000000000000000000070000000007
700000000700000000000000000007000000000000000000070000000007
700000000700000000000000000007000000000000000000070000000007
700000000700000000000000000007000000000000000000070000000007
700000000700000000000000000007000000000000000000070000000007
700000000700000000070000000007000000000700000000070000000007
700000000700000000070000000007000000000700000000070000000007
700000000700000000070000000007000000000700000000070000000007
700000000700000000070000000007000000000700000000070000000007
700000000700000000070000000007000000000700000000070000000007
700000000700000000070000000007000000000700000000070000000007
700000000700000000070000000007000000000700000000070000000007
700000000700000000070000000007000000000700000000070000000007
700000000700000000070000000007000000000700000000070000000007
700000000700000000070000000007000000000700000000070000000007
700000000700000000070000000007000000000700000000070000000007
700000000700000000070000000007000000000700000000070000000007
700000000700000000070000000007000000000700000000070000000007
700000000700000000070000000007000000000700000000070000000007
700000000700000000070000000007000000000700000000070000000007
700000000700000000070000000007000000000700000000070000000007
700000000700000000070000000007000000000700000000070000000007
700000000700000000070000000007000000000700000000070000000007
700000000000000000070000000000000000000700000000000000000007
700000000000000000070000000000000000000700000000000000000007
700000000000000000070000000000000000000700000000000000000007
700000000000000000070000000000000000000700000000000000000007
700000000000000000070000000000000000000700000000000000000007
777777777777777777777777777777777777777777777777777777777777