999999999999999999999999999999999999999999999999999999999999
900000000900000000000000000009000000000000000000090000000009
900000000000000000090000000000000000000900000000000000000009
900000000900000000000000000009000000000000000000090000000009
900000000000000000090000000000000000000900000000000000000009
900000000900000000000000000009000000000000000000090000000009
900000000000000000090000000000000000000900000000000000000009
900000000900000000000000000009000000000000000000090000000009
900000000000000000090000000000000000000900000000000000000009
900000000900000000000000000009000000000000000000090000000009
900000000000000000090000000000000000000900000000000000000009
900000000900000000000000000009000000000000000000090000000009
900000000000000000090000000000000000000900000000000000000009
900000000900000000000000000009000000000000000000090000000009
900000000000000000090000000000000000000900000000000000000009
900000000900000000000000000009000000000000000000090000000009
900000000000000000090000000000000000000900000000000000000009
900000000900000000000000000009000000000000000000090000000009
900000000000000000090000000000000000000900000000000000000009
900000000900000000000000000009000000000000000000090000000009
900000000000000000090000000000000000000900000000000000000009
900000000900000000000000000009000000000000000000090000000009
900000000000000000090000000000000000000900000000000000000009
900000000900000000000000000009000000000000000000090000000009
900000000000000000090000000000000000000900000000000000000009
900000000900000000000000000009000000000000000000090000000009
900000000000000000090000000000000000000900000000000000000009
900000000900000000000000000009000000000000000000090000000009
900000000000000000090000000000000000000900000000000000000009
999999999999999999999999999999999999999999999999999999999999