000000000000003000000000000000000000000000000000000000000000
000000000000003000000000000000000000000000000000000000000000
000000000000003000000000000000000000000000000000000000000000
000000000000003000000000000000000000000000000000000000000000
000000000000003000000000000000000000000000000000000000000000
000000000000003000000000000000000000000000000000000000000000
000000000000003000000000000000000000000000000000000000000000
000000000000003000000000000000333333333333333333333333333333
000000000000003000000000000000000000000000000000000000000000
000000000000003000000000000000000000000000000000000000000000
000000000000003000000000000000000000000000000000000000000000
000000000000003000000000000000000000000000000000000000000000
000000000000003000000000000000000000000000000000000000000000
000000000000003000000000000000000000000000000000000000000000
000000000000003000000000000000000000000000000000000000000000
000000000000000000000000000000000000000000000300000000000000
000000000000000000000000000000000000000000000300000000000000
000000000000000000000000000000000000000000000300000000000000
000000000000000000000000000000000000000000000300000000000000
000000000000000000000000000000000000000000000300000000000000
000000000000000000000000000000000000000000000300000000000000
000000000000000000000000000000000000000000000300000000000000
333333333333333333333333333333000000000000000300000000000000
000000000000000000000000000000000000000000000300000000000000
000000000000000000000000000000000000000000000300000000000000
000000000000000000000000000000000000000000000300000000000000
000000000000000000000000000000000000000000000300000000000000
000000000000000000000000000000000000000000000300000000000000
000000000000000000000000000000000000000000000300000000000000
000000000000000000000000000000000000000000000300000000000000