555555555555555555555555555555555555555555555555555555555555
500000000500000000050000000005000000000500000000050000000005
500000000500000000050000000005000000000500000000050000000005
500000000500000000050000000005000000000500000000050000000005
500000000500000000050000000005000000000500000000050000000005
500000000500000000050000000005000000000500000000050000000005
500000000500000000050000000005000000000500000000050000000005
500000000500000000050000000005000000000500000000050000000005
500000000500000000050000000005000000000500000000050000000005
500000000500000000050000000005000000000500000000050000000005
500000000500000000050000000005000000000500000000050000000005
500000000500000000050000000005000000000500000000050000000005
500000000500000000050000000005000000000500000000050000000005
000000000000000000000000000000000000000000000000000000000000
000000000000000000000000000000000000000000000000000000000000
000000000000000000000000000000000000000000000000000000000000
000000000000000000000000000000000000000000000000000000000000
500000000500000000050000000005000000000500000000050000000005
500000000500000000050000000005000000000500000000050000000005
500000000500000000050000000005000000000500000000050000000005
500000000500000000050000000005000000000500000000050000000005
500000000500000000050000000005000000000500000000050000000005
500000000500000000050000000005000000000500000000050000000005
500000000500000000050000000005000000000500000000050000000005
500000000500000000050000000005000000000500000000050000000005
500000000500000000050000000005000000000500000000050000000005
500000000500000000050000000005000000000500000000050000000005
500000000500000000050000000005000000000500000000050000000005
500000000500000000050000000005000000000500000000050000000005
555555555555555555555555555555555555555555555555555555555555